.........BP....BB...BB................
....BBP..BPP.........BBP..............
......................................
......................................
............................P....P....
BBBBBBBBBBBBBBBBBBBBBBBBBBBBBBBBBBBBBB