..B...B.....BB.......
.....................
.....................
.....................
BBBBBBBBBBBBBBBBBBBBB
