..................
..................
............B.....
.........B..B.....
....PPBPPBPPB.....
BBBBBBBBBBBBBBBBBB