..................................................................
..............................B.......................PP..........
.......................................P..............P...........
............................B....................P.BB.............
.....P.........P..PP.....B..PPPP........P....BBBBB................
BBBBBBBBBBBBBBBBBBBBBBBBBBBBBBBBBBBBBBBBBBBBBBBBBBBBBBBBBBBBBBBBBB