....BBBBBB.............
.......................
.......................
.......................
.......................
BBBBBBBBBBBBBBBBBBBBBBB